1111111111111
1C010000000C1
1000011111001
100011C000001
1000110000001
1P0011E000001
1111111111111