1111111111111
1P1C1C1C1C101
1000000000001
101C1C1C1C101
1000000000001
101C1C1C1C1E1
1111111111111