11111111111111111111111111111111
1EC000000000000000000000000000C1
10100101001000001010010000010101
1010010C101010100C10010000010101
1P0000000000C00000000000000000C1
11111111111111111111111111111111